######
#    #
###  #
#### #
###  #
###  #
##   #
#### #
##   #
#!   #
######