##################
# #!#            #
# # #  #         #
# #   #####      #
# #########      #
#         #      #
#########  #     #
# #        ##    #
##     #    #    #
#####   #######  #
#   #        #   #
#    ####   #    #
#  #       #     #
#  ##########    #
#     #     #    #
#  #     #    #  #
##################