##########
#   # #  #
#   ##   #
#   # #  #
#   ##   #
#   # #  #
#   ##   #
#   # #  #
#   ##   #
#   # #  #
#   ##   #
#    !   #
##########