##############
############ #
##           #
#### #########
###          #
###########  #
#### !  ### ##
#        ##  #
#####        #
#            #
#     #      #
#   #    #   #
#            #
##############