######################################
#                                    #
###################################  #
#                               #    #
#####  ######   #################    #
#!     #                             #
######################################