######################
###                  #
####                 #
#####                #
######               #
#######              #
########             #
#########            #
##########           #
###########          #
############         #
#############       !#
######################