#############
#    #      #
###  #  ##! #
#   ##   ####
###  ### ####
#   ###  ####
# ## ## #####
#    #  #####
#### ##  ####
##   ### ####
#  ###   ####
#      ######
#############